■□P#?□□□?#P□□□
■∙∙∙∙∙#∙∙∙∙∙∙□
■∙?∙∙##A∙∙─#∙P
■P#1∙∙∙∙∙∙A#∙?
■∙#∙─?─#P∙─#─□
■□□□□#□∙∙∙∙∙∙□
■#□□□2#∙##P∙#B
□#□%□P□∙P∙∙∙∙□
□□□%□□■■■■■■■■