■□□□?#P□□□#?□□
■∙P∙∙#∙∙∙∙∙∙∙□
■∙#∙∙∙∙∙∙P─#A□
■1#∙P##A∙#∙∙∙□
■∙─∙─∙─∙─#P∙─?
■#P□□P□∙∙∙∙∙P#
■#□□□#□∙∙B#∙∙#
□P□%□2#P∙∙#∙∙□
□□□%□□■■■■■■■■