■□□□?#P□□□#?□□
■∙P∙∙#∙∙∙∙∙∙∙□
■∙#∙∙∙∙∙∙P─#A□
■1#∙P?#A∙#∙∙∙□
■∙─∙─∙─∙─#?∙─?
■#□□□P□∙∙∙∙∙P#
■#□□□#□∙∙B#∙∙?
□?□%□2#P∙∙#∙∙□
□□□%□□■■■■■■■■