■?P#□□#P?□□□□□
■∙∙∙∙∙#∙∙∙P∙∙□
■∙∙#1∙∙∙∙∙#∙A#
■P##∙∙∙#A∙#∙∙?
■∙─∙─P##─∙?∙─□
■#P□□□□∙∙∙∙∙∙□
■#□□□2#∙#∙B#∙P
□P□%□□□∙P∙∙#∙?
□□□%□□■■■■■■■■