■?P#□□#P?□□□□□
■∙∙∙∙∙#∙∙∙P∙∙□
■∙∙#1∙∙∙∙∙#∙A#
■P##∙∙∙#A∙#∙∙?
■∙─∙─P##─∙?∙─□
■#□□□□□∙∙∙∙∙∙□
■#□□□2#∙#∙B#∙P
□?□%□□□∙P∙∙#∙?
□□□%□□■■■■■■■■