■□#P□□?#P□□□□□
■∙∙∙∙∙∙∙∙∙##A□
■?∙∙∙#A∙?∙P∙∙□
■##1∙∙∙∙#∙∙∙##
■P─∙─P─##∙─∙─#
■□□□□#□?∙∙∙P∙?
■#□□□#□∙∙B##∙□
□P□%□2#∙∙#∙∙∙□
□□□%□□■■■■■■■■