■□##P□□□P##?□□
■∙#∙∙∙∙∙∙∙∙∙∙□
■1#∙?##∙∙∙A#∙□
■∙∙∙∙∙#A∙∙#∙∙P
■P##2∙─∙─P#∙─?
■□□□□□P∙∙∙∙∙∙□
■?□□□□#∙∙#?#B□
□#□%□P#?∙P∙∙∙□
□□□%□□■■■■■■■■