■□#P□□?P□□#P□□
■∙∙∙∙∙∙∙∙∙#∙∙□
■1#∙∙∙A#?∙#∙∙□
■∙#∙?##∙∙∙#A∙□
■∙P∙─∙─∙─∙─∙─P
■□□□□#2∙P∙∙∙∙□
■?□□□#□∙##B#∙□
□#□%□?□P#∙∙∙∙□
□□□%□□■■■■■■■■