■□#P□□?P□□#P□□
■∙∙∙∙∙∙∙∙∙#∙∙□
■1#∙∙∙A#?∙#∙∙□
■∙#∙?##∙∙∙#A∙□
■∙P∙─∙─∙─∙─∙─P
■□□□P#2∙P∙∙∙∙□
■?□□□#□∙##B#∙□
□P□%□?□P#∙∙∙∙□
□□□%□□■■■■■■■■