■□□?##A□□P#?□□
■∙∙∙∙∙∙∙∙∙∙∙∙□
■1#∙P∙∙∙∙∙#P∙□
■∙P∙##?∙A##∙∙□
■∙─∙─∙─∙#∙─∙P#
■#□□□2#∙?∙∙∙∙?
■#□□□□P∙###B∙□
□P□%□□□∙∙P∙∙∙□
□□□%□□■■■■■■■■