■□□P#□□?P□□A##
■∙∙∙#∙∙∙∙∙∙∙∙□
■#1∙?∙∙∙∙#P∙∙□
■?∙∙#P∙∙A#∙∙∙□
■∙─∙─∙─∙─∙─∙─P
■P□□□####∙P∙∙#
■#□□□2□∙#∙#∙B#
□?□%□□□∙P∙?∙∙□
□□□%□□■■■■■■■■