■□□P□□□?##P□□#
■∙∙∙∙∙∙∙∙∙∙∙∙?
■∙∙?∙##A∙∙─#∙□
■∙1#∙∙∙∙∙∙#A∙□
■∙─##?─∙P##∙─P
■?□P□□□∙∙∙∙∙∙#
■#□□□#2∙#∙B#∙P
□P□%□P□∙P∙∙#∙□
□□□%□□■■■■■■■■