■□□P##A□□P#□□□
■∙∙∙∙#∙∙∙∙#∙∙□
■#1∙∙?∙#∙∙─∙∙□
■?∙∙P#∙##∙A#∙P
■∙─∙─∙─∙─∙─∙─#
■###2□?∙∙#∙P∙?
■#□□□□#∙B#─∙∙□
□P□%□P#∙∙##?∙□
□□□%□□■■■■■■■■