■□□?#□□A#□□P##
■P∙∙∙∙∙#∙∙∙∙∙#
■#?#1∙∙#∙∙A#∙?
■∙∙∙∙∙∙∙∙∙∙∙∙□
■#2∙P#─∙─P─∙─□
■#□□□#P∙∙#∙∙∙P
■#□□□#□∙B###∙?
□P□%□?□∙∙#∙∙∙□
□□□%□□■■■■■■■■