■□□##?□□□A#□□□
■∙∙∙∙∙∙∙∙∙∙∙∙□
■∙P∙A#?#∙#?∙∙□
■1#∙?∙∙P∙∙∙∙∙P
■∙─∙─∙─∙─∙#∙─#
■P□□□#2∙∙∙#B∙□
■#□□□□□∙P∙#∙∙□
□?□%□P#?#∙P∙∙□
□□□%□□■■■■■■■■