∙∙∙∙∙∙∙∙∙∙∙∙∙∙
∙##∙P∙##∙P##∙∙
∙#1∙#∙A#∙∙#A∙∙
∙∙∙∙#∙∙∙∙∙∙∙∙∙
∙∙#∙#P∙∙∙P##P∙
∙P#∙∙∙∙P∙∙∙∙∙∙
∙∙∙∙∙∙##∙∙###∙
∙∙∙%∙2#∙∙∙#B∙∙
∙P∙%∙∙∙∙∙∙∙∙∙∙