∙∙∙∙∙∙∙∙∙∙∙∙∙#
∙#?∙##F∙∙∙%∙##
∙#∙∙P∙∙∙P∙%∙P∙
∙∙∙∙∙∙∙∙#∙∙∙∙∙
∙P#∙#P∙P#P∙P∙∙
∙∙∙∙#∙∙∙∙∙∙##∙
∙#C∙∙∙∙∙E#∙P∙∙
∙##∙P#∙∙##∙∙∙∙
∙∙∙∙∙∙∙∙∙∙∙∙∙∙