∙∙∙∙∙∙∙∙∙∙∙∙∙∙∙∙∙∙∙∙∙
∙##+###∙##∙P∙##∙P##∙∙
∙#--=K#∙#A∙#∙B#∙∙#$∙∙
∙+--=-+∙∙∙∙#∙∙∙∙∙∙∙∙∙
∙#O---#∙∙#∙#P∙∙∙P##P∙
∙##+###∙P#∙∙∙∙P∙∙∙∙∙∙
∙∙∙∙∙∙∙∙∙∙∙∙∙##∙∙###∙
∙#?∙##P∙∙∙%∙##∙∙∙#Z∙∙
∙#∙∙P∙∙∙P∙%∙P∙∙∙∙∙∙∙∙
∙∙∙∙∙∙∙∙#∙∙∙∙∙##+###∙
∙P#∙#P∙P#P∙P∙∙#O-=K#∙
∙∙∙∙#∙∙∙∙∙∙##∙+--=-+∙
∙#C∙∙∙∙∙E#∙P∙∙#----#∙
∙##∙P#∙∙##∙∙∙∙##+###∙
∙∙∙∙∙∙∙∙∙∙∙∙∙∙∙∙∙∙∙∙∙