∙∙∙∙∙∙∙∙∙∙∙∙∙∙∙∙∙∙∙∙∙
∙##+###∙##∙∙∙##∙∙∙∙∙∙
∙#--=K#∙#A∙∙∙B#∙∙∙∙∙∙
∙+--=-+∙∙∙∙∙∙∙∙∙∙∙∙∙∙
∙#O---#∙∙∙∙∙∙S∙∙∙∙∙∙∙
∙##+###∙∙∙∙∙SS∙∙∙∙∙∙∙
∙∙∙∙∙∙∙∙∙∙∙∙∙∙∙∙∙∙∙∙∙
∙∙∙∙∙∙∙∙∙∙∙∙∙∙∙∙∙∙∙∙∙
∙∙∙S∙∙∙?∙∙∙$∙∙∙Z∙∙∙∙∙
∙∙∙SS∙∙∙∙∙∙∙∙∙##+###∙
∙∙∙∙∙∙∙∙∙∙∙∙∙∙#O-=K#∙
∙∙∙∙∙∙∙∙∙∙∙∙∙∙+--=-+∙
∙#C∙∙∙∙∙E#∙∙∙∙#----#∙
∙##∙∙∙∙∙##∙∙∙∙##+###∙
∙∙∙∙∙∙∙∙∙∙∙∙∙∙∙∙∙∙∙∙∙