∙∙∙∙∙∙∙∙∙∙∙∙∙∙∙∙∙∙∙∙∙
∙##+###∙##∙#∙##∙###∙∙
∙#--=K#∙#A∙#∙B#∙∙#$∙∙
∙+--=-+∙∙∙∙P∙∙∙∙∙∙∙∙∙
∙#O---#∙∙#∙##∙∙∙##P#∙
∙##+###∙#P∙∙∙∙#∙∙∙∙∙∙
∙∙∙∙∙∙∙∙∙∙∙∙∙#P∙∙###∙
∙#?∙P##∙∙∙%∙P#∙∙∙#Z∙∙
∙#∙∙#∙∙∙#∙%∙#∙∙∙∙∙∙∙∙
∙∙∙∙∙∙∙∙P∙∙∙∙∙##+###∙
∙P#∙P#∙###∙#∙∙#O-=K#∙
∙∙∙∙#∙∙∙∙∙∙#P∙+--=-+∙
∙#C∙∙∙∙∙E#∙#∙∙#----#∙
∙##∙#P∙∙##∙∙∙∙##+###∙
∙∙∙∙∙∙∙∙∙∙∙∙∙∙∙∙∙∙∙∙∙