∙∙∙∙∙∙∙∙∙∙∙∙∙∙
∙##∙P∙##∙P##∙∙
∙#A∙#∙B#∙∙#$∙∙
∙∙∙∙#∙∙∙∙∙∙∙∙∙
∙∙#∙#P∙∙∙P##P∙
∙P#∙∙∙∙P∙∙∙∙∙∙
∙∙∙∙∙∙##∙∙###∙
∙∙∙%∙##∙∙∙#Z∙∙
∙P∙%∙P∙∙∙∙∙∙∙∙